C 250,255,255

NO          ./textures/wall.xpm
F 135,206,          235         


SO ./textures/wall1.xpm


WE ./textures/wall2.xpm


EA ./textures/wall3.xpm







11111111111111111111
1000000000000000011111111
11000000001111110001
1111001100110011N011
10000000000000000111
11111111110000001111
11111111111111111111
