SO ./textures/bricks.xpm



NO ./textures/bricks.xpm

             
WE ./textures/bricks.xpm
EA ./textures/bricks.xpm









F 0,0,111
C 255,255,255

           
1111111111111111111111111
1000000000110000000000001
1011000001110000000000001
1001000000000000000000001
111111111011000D0011100001
100000000011000001110111111111111
11110111111111011100000010001
11110111111111011101010010001
110D00000110101011100000010001
100000000000000011000000D0001
1000000000D0000001101010010001
11000001110101011111011110N0111
11110111 1110101 101111010001
11111111 1111111 111111111111