1111111111111111111111111111111111
100000000000Y1C10000C0000000000001
1010010100100001101001000000010101
1010010110101010001001C000Y0010101
1P1001110C00C0000000000000000001E1
1111111111111111111111111111111111